R 1320     755           
NO   ./textures/roll.xpm         
     
SO ./textures/bat.xpm    
   WE ./textures/zombie.xpm
EA ./textures/police.xpm

S2 ./textures/microbeB.xpm
S3 ./textures/rollB.xpm
F ./textures/wood.xpm
C ./textures/purplestone.xpm

        1111111111111111111111111
        1000000000110002222222001
        10110000011100E0022220001
        1001000000000000000000001
111111111011000001110000000000001
100000000011000001110111111111111
11110111111111011100000000221
11110111111111011101010010021
11000000110101011100002013021
12222000000002221100000013021
12222000020000221101012210021
11000001110101011111011110021
11010111111101011101111010001
11011111111111111111111111111
110111111 1111
110111111 1111
1100001
1001001
1101111
1000001
1000001
1111001
1000001
1000001
1111111
