R     1000      800           
NO   ./textures/42_logo.xpm         
     
SO ./textures/42_logo_inv.xpm    
   WE ./textures/42_logo.xpm
EA ./textures/42_logo_inv.xpm

S2 ./textures/microbeB.xpm
S3 ./textures/rollB.xpm
S4 ./textures/pillar.xpm
S5 ./textures/42_logo.xpm
S6 ./textures/42_logo_inv.xpm
S7 ./textures/stairs_down.xpm
S8 ./textures/stairs_up.xpm
F ./textures/grey_floor.xpm
C ./textures/electronics.xpm


1111111111111111111111111111111
1000000000000000000000000000001
1000000000000000000000000000001
1000000000000000000000000000001
1000000000000000000000000000001
1000000000040000000400000000001
1000000000040000000000000000001
1000000000000000000000000000001
1000000000040000000400000000001
1000000000000000000000000000001
1000000000000000000000000000001
1000000000040000000400000000001
1000000000000000000000000000001
1000000000000000000000000000001
1111111111115111111111111111111
1000000000110100100010000000001
1000000000150100100010000000001
1000000000110100100010000000001
1111111511110111111110000000001
1E000000000000000000000000000011111111111111111
10111110000000000000000000000010000000000000001
18111000000000000000000000000010000000000000001
11111010000000000000000000000010000000000000001
11111710000000000000000000000060000000000000001
11111111111111111111100000000011111110000000001
                    100000000011111110000000001
                    100000000011111110000000001
                    111111111111111111111111111
