R 700     700           
NO   ./textures/mountain.xpm         
     
SO ./textures/bat.xpm    
   WE ./textures/zombie.xpm
EA ./textures/police.xpm

S2 ./textures/microbeB.xpm
S3 ./textures/rollB.xpm
F ./textures/wood.xpm
C ./textures/purplestone.xpm

1111111111111
1000000000001
1000000000001
1000000000001
1000000000001
1000000000001
100000E000001
1000000000001
1000000000001
1000000000001
1000000000001
1000000000001
1111111111111
