R     1500 100
NO   ./textures/roll.xpm         
     
SO ./textures/bat.xpm    
   WE ./textures/zombie.xpm
EA ./textures/police.xpm

S ./textures/micrbeB.xpm
F 50, 156, 31
C     53, 189, 219  

111111111111
10N001
111111
