R     150495794574597249529700 957497549754975497594759475          
NO   ./textures/roll.xpm         
     
SO ./textures/bat.xpm    
   WE ./textures/zombie.xpm
EA ./textures/police.xpm

S ./textures/microbeB.xpm
F 50, 156, 31
C     53, 189, 219  

1111111111111
1000000000001
1000000000001
1000000000001
1000000000001
1000000000001
100000S000001
1000000000001
1000000000001
1000002000001
1000000000001
1000000000001
1111111111111
