R 1920 1080
NO   ./textures/roll.xpm         
     
SO ./textures/bat.xpm    
   WE ./textures/zombie.xpm
EA ./textures/police.xpm

S ./textures/microbeB.xpm
F 220,100,0
C 225,30,0

        1111111111111111111111111
        1000000000110000000000001
        1011000001110000002000001
        1001000000022222222220001
111111111011000001110000000000001
100000000011000001110111111111111
1111011111111101110000000222221
1111011111111101110101001222221
1100000011010101110000001222221
1000200000000000110000001222221
1000000000000000110101001222221
11000001110101011111011110N0111
11110111 1110101 101111010001
11111111 1111111 111111111111
