R     1500       1000           
NO   ./path_to_the_north_texture.xpm         
     
SO ./path_to_the_south_texture.xpm    
   WE ./path_to_the_west_texture.xpm
EA ./path_to_the_east_texture.xpm

S ./path_to_the_sprite_texture.xpm
F 22,10,05
C     255  ,    30   ,    065   

 111
 1S1111
1100021
1001001
1101111
1000001
1000001
1111001
1000001
1000001
1111111
11111111111111111111
        1111111111111111111111111
        1000000000110000000000001
        1011000001110000002000001
        1001000000000000000000001
111111111011000001110000000000001
100000000011000001110111111111111
11110111111111011100000000001
11110111111111011101010010001
11000000110101011100000100001    
100020000000000011000000100011  
100000000000000001101010010001   
110000011101010111110111100111
11110111 1110101 101111010001
11111111 1111111 111111111111
