R     1200      750            
NO   ./textures/42_logo.xpm         
     
SO ./textures/42_logo_inv.xpm    
   WE ./textures/42_logo.xpm
EA ./textures/42_logo_inv.xpm

S2 ./textures/microbeB.xpm
S3 ./textures/rollB.xpm
S4 ./textures/pillar.xpm
S5 ./textures/Norminet.xpm
S6 ./textures/42_logo_inv.xpm
S7 ./textures/stairs_down.xpm
S8 ./textures/stairs_up.xpm
S9 ./textures/elevator.xpm
F ./textures/grey_floor.xpm
C ./textures/electronics.xpm

11111111111111111111
10000000000000000001
10000000000000000001
10000000000000000001
10000000000000000001
10000000000000000001
10000000000000000001
16111111111111111111
10000040000004000001
10000000000000000001
10000000002000000001
10000040000024000001
10000000020000000001
10000000000000003001
11111116111111111111
10023110101000100001
10000190101000100501
10000110101000100001
11116110111111161111
10000000000000002221
1N111111111111111111
18111
11111
11111
11111
