R     1200      750         
NO   ./textures/42_logo.xpm         
     
SO ./textures/42_logo_inv.xpm    
   WE ./textures/42_logo.xpm
EA ./textures/42_logo_inv.xpm

S2 ./textures/microbeB.xpm
S3 ./textures/rollB.xpm
S4 ./textures/pillar.xpm
S5 ./textures/42_logo.xpm
S6 ./textures/42_logo_inv.xpm
S7 ./textures/stairs_down.xpm
S8 ./textures/stairs_up.xpm
S9 ./textures/elevator.xpm
F ./textures/grey_floor.xpm
C ./textures/electronics.xpm


11111111111111111111
10000000000000000001
10000000000000000001
10000000000000000001
10000000000000000001
10000004000004000001
10000000000000000001
10000000000000000001
10000004000004000001
10000000000000000001
10000000000000000001
10000004000004000001
10000000000000000001
10000000000000000001
11111111611111111111
10000011010100100001
10000019010100100001
10000011010100100001
11111611011111100001
1000000000000000000111111111111
1011100000000000000100000000001
1810000000000000000100000000001
111N100000000000000100000000001
1117100000000000000600000000001
1111111111111110000111111100001
              10000111111100001
              10000111111100001
              111111111111111111
