R 1320     755           
NO   ./textures/roll.xpm         
     
SO ./textures/bat.xpm    
   WE ./textures/zombie.xpm
EA ./textures/police.xpm

S2 ./textures/microbeB.xpm
S3 ./textures/rollB.xpm
F ./textures/wood.xpm
C ./textures/purplestone.xpm

1111111
1112001
1000301
1000001
1000001
1000001
100N001
1000001
1111111
