R     1200      750           
NO   ./textures/42_logo.xpm         
     
SO ./textures/42_logo_inv.xpm    
   WE ./textures/42_logo.xpm
EA ./textures/42_logo_inv.xpm

S2 ./textures/microbeB.xpm
S3 ./textures/rollB.xpm
S4 ./textures/pillar.xpm
S5 ./textures/Norminet.xpm
S6 ./textures/42_logo_inv.xpm
S7 ./textures/stairs_down.xpm
S8 ./textures/stairs_up.xpm
S9 ./textures/elevator.xpm
F ./textures/grey_floor.xpm
C ./textures/electronics.xpm

11111111111111111111
10000000000000000001
10000000020000000001
10020000002000000001
10000000000000000001
10000004000004002001
10000000000000000001
10020000000000000001
10000004000004002001
10000000002000000001
10000000000000000001
10002004000004000001
10000000200200000001
10000000000000000001
11111111611111111111
10300311012220000001
10000219010000220001
13020011010022220001
11111611011611111111
10000000000000000011111111111111
10N11000100000000000000200000001
18710000100000020000000000000001
11110000100000000000000000002001
11110000100000000011111111611111
11111111100000000010000000000001
        102000000010000033300001
        100000000010000000000001
        111111111111111111111111
