R     1200      750            
NO   ./textures/42_logo.xpm         
     
SO ./textures/42_logo_inv.xpm    
   WE ./textures/42_logo.xpm
EA ./textures/42_logo_inv.xpm

S2 ./textures/microbeB.xpm
S3 ./textures/rollB.xpm
S4 ./textures/pillar.xpm
S5 ./textures/Norminet.xpm
S6 ./textures/42_logo_inv.xpm
S7 ./textures/stairs_down.xpm
S8 ./textures/stairs_up.xpm
S9 ./textures/elevator.xpm
F ./textures/grey_floor.xpm
C ./textures/electronics.xpm


11111111111111111111
10000000000000000001
10000000020000000001
10020000002000000001
10000000000000000001
10000004000004002001
10000000000000000001
10020000000000000001
10000004000004002001
10000000002000000001
10000000000000000001
10002004000004000001
10000000200200000001
10000000000000000001
11111111161111111111
10000331101000000001
10000001901000000001
13022001101000020001
11111161101100000001
10000000000600200001111111111111
10N11111111100000001100000000001
11710000000000000001000000000001
11110000000000002001000000000001
11110033000000000001000000000001
11111111111111111111111100000001
              100001111100000001
              100001111100000001
              111111111111111111
