R     1000      700           
NO   ./textures/eggplant.xpm         
     
SO ./textures/intellol.xpm    
   WE ./textures/IDK.xpm
EA ./textures/microbe.xpm

S ./path_to_the_sprite_texture.xpm
F 50, 156, 31
C     53, 189, 219  

1111111111111
11S1111111111
1100001
1001001
1101111
1000001
1000001
1111001
1000001
1000001
1111111111111
