R     700      500           
NO   ./textures/roll.xpm         
     
SO ./textures/bat.xpm    
   WE ./textures/zombie.xpm
EA ./textures/police.xpm

S ./textures/microbeB.xpm
F 50, 156, 31
C     53, 189, 219  

        1111111111111111111111111
        1000000000110002222222001
        1011000001110000022220001
        1001000000000000000000001
111111111011000001110000000000001
100000000011000001110111111111111
11110111111111011100000000221
11110111111111011101010010021
11000000110101011100002010021
12222000000002221100000010021
12222000020W00221101012210001
110000011101010111110111100111
11010111111101011101111010001
110111111111111111111111111111
110111111 1111
110111111 1111
1100001
1001001
1101111
1000001
1000001
1111001
1000001
1000001
1111111111111
