R     1000      700           
NO   ./textures/eggplant.xpm         
     
SO ./textures/intellol.xpm    
SO ./textures/intellol.xpm    
   WE ./textures/IDK.xpm
EA ./textures/microbe.xpm

S ./path_to_the_sprite_texture.xpm
F 50, 156, 31
C     53, 189, 219  

1111111111111
1000001100011
10000S1101101111
1000001001000001
1011110100001111
1000000000011
11111111111111111
